The 100 Series - Kass Morgan
Alex Rider - Anthony Horowitz
All For The Game - Nora Sakavic
Animorphs - Katherine A*d* Applegate
Anne of Green Gables - L*d* M*d* Montgomery
Captive Prince - C*d* S*d* Pacat
Carry On Series - Rainbow Rowell
Chronicles of Narnia - C*d* S*d* Lewis
Cormoran Strike Series - Robert Galbraith
A Court of Thorns and Roses Series - Sarah J*d* Maas
The Dark Artifices Series - Cassandra Clare
Discworld - Terry Pratchett
Divergent Series - Veronica Roth
The Dresden Files - Jim Butcher
Good Omens - Neil Gaiman *a* Terry Pratchett
The Grisha Trilogy - Leigh Bardugo
Harry Potter - J*d* K*d* Rowling
The Heroes of Olympus - Rick Riordan
His Dark Materials - Philip Pullman
The Hobbit - J*d* R*d* R*d* Tolkien
Hunger Games Trilogy - Suzanne Collins
The Infernal Devices Series - Cassandra Clare
IT - Stephen King
The Lord of the Rings - J*d* R*d* R*d* Tolkien
Magnus Chase and the Gods of Asgard - Rick Riordan
The Maze Runner Series - James Dashner
Les Misérables - Schönberg*s*Boublil
Les Misérables - Victor Hugo
The Mortal Instruments Series - Cassandra Clare
Mumintroll | Moomins Series - Tove Jansson
Outlander Series - Diana Gabaldon
The Outsiders - S*d* E*d* Hinton
Parahumans Series - Wildbow
Percy Jackson and the Olympians - Rick Riordan
Poirot - Agatha Christie
Pride and Prejudice - Jane Austen
Raven Cycle - Maggie Stiefvater
Red White *a* Royal Blue - Casey McQuiston
A Series of Unfortunate Events - Lemony Snicket
The Shadowhunter Chronicles - Cassandra Clare
Sherlock Holmes - Arthur Conan Doyle
The Silmarillion and other histories of Middle-Earth - J*d* R*d* R*d* Tolkien
Simonverse | Creekwood Series - Becky Albertalli
Six of Crows Series - Leigh Bardugo
The Song of Achilles - Madeline Miller
A Song of Ice and Fire - George R*d* R*d* Martin
Throne of Glass Series - Sarah J*d* Maas
Tortall - Tamora Pierce
The Trials of Apollo - Rick Riordan
Twilight Series - Stephenie Meyer
Vampire Chronicles - Anne Rice
Vorkosigan Saga - Lois McMaster Bujold
Warriors - Erin Hunter
Wiedźmin | The Witcher Series - Andrzej Sapkowski
